Name            : vlc
Version         : 3.0.16-3
Description     : Multi-platform MPEG, VCD/DVD, and DivX player
Architecture    : x86_64
URL             : https://www.videolan.org/vlc/
Licenses        : LGPL2.1  GPL2
Groups          : None
Provides        : None
Depends On      : a52dec  libdvbpsi  libxpm  libdca  libproxy  lua52  libidn  libmatroska  taglib  libmpcdec  ffmpeg  faad2  libmad  libmpeg2  xcb-util-keysyms  libtar  libxinerama  libsecret  libupnp  libixml.so=11-64  libupnp.so=17-64  libarchive  qt5-base  qt5-x11extras  qt5-svg  freetype2  fribidi  harfbuzz  fontconfig  libxml2  gnutls  libplacebo  wayland-protocols
Optional Deps   : avahi: service discovery using bonjour protocol [installed]
                  aom: AOM AV1 codec [installed]
                  gst-plugins-base-libs: for libgst plugins [installed]
                  dav1d: dav1d AV1 decoder [installed]
                  libdvdcss: decoding encrypted DVDs
                  libavc1394: devices using the 1394ta AV/C [installed]
                  libdc1394: IEEE 1394 access plugin [installed]
                  kwallet: kwallet keystore [installed]
                  libva-vdpau-driver: vdpau backend nvidia
                  libva-intel-driver: video backend intel
                  libbluray: Blu-Ray video input [installed]
                  flac: Free Lossless Audio Codec plugin [installed]
                  twolame: TwoLAME mpeg2 encoder plugin [installed]
                  libgme: Game Music Emu plugin [installed]
                  vcdimager: navigate VCD with libvcdinfo
                  libmtp: MTP devices discovery [installed]
                  systemd-libs: udev services discovery [installed]
                  smbclient: SMB access plugin [installed]
                  libcdio: audio CD playback
                  gnu-free-fonts: subtitle font  [installed]
                  ttf-dejavu: subtitle font
                  libssh2: sftp access [installed]
                  libnfs: NFS access
                  mpg123: mpg123 codec [installed]
                  protobuf: chromecast streaming [installed]
                  libmicrodns: mDNS services discovery (chromecast etc) [installed]
                  lua52-socket: http interface
                  libdvdread: DVD input module [installed]
                  libdvdnav: DVD with navigation input module [installed]
                  libogg: Ogg and OggSpots codec [installed]
                  libshout: shoutcast/icecast output plugin [installed]
                  libmodplug: MOD output plugin [installed]
                  libvpx: VP8 and VP9 codec [installed]
                  libvorbis: Vorbis decoder/encoder [installed]
                  speex: Speex codec [installed]
                  opus: opus codec [installed]
                  libtheora: theora codec [installed]
                  libpng: PNG support [installed]
                  libjpeg-turbo: JPEG support [installed]
                  librsvg: SVG plugin [installed]
                  x264: H264 encoding [installed]
                  x265: HEVC/H.265 encoder [installed]
                  zvbi: VBI/Teletext/webcam/v4l2 capture/decoding [installed]
                  libass: Subtitle support [installed]
                  libkate: Kate codec [installed]
                  libtiger: Tiger rendering for Kate streams
                  sdl_image: SDL image support
                  srt: SRT input/output plugin [installed]
                  aalib: ASCII art video output [installed]
                  libcaca: colored ASCII art video output [installed]
                  libpulse: PulseAudio audio output [installed]
                  alsa-lib: ALSA audio output [installed]
                  jack: jack audio server [installed]
                  libsamplerate: audio Resampler [installed]
                  libsoxr: SoX audio Resampler [installed]
                  chromaprint: Chromaprint audio fingerprinter [installed]
                  lirc: lirc control
                  libgoom2: Goom visualization
                  projectm: ProjectM visualisation
                  ncurses: ncurses interface [installed]
                  libnotify: notification plugin [installed]
                  gtk3: notification plugin [installed]
                  aribb24: aribsub support
                  aribb25: aribcam support
                  pcsclite: aribcam support
Required By     : phonon-qt5-vlc
Optional For    : None
Conflicts With  : vlc-plugin
Replaces        : vlc-plugin
Installed Size  : 59.77 MiB
Packager        : Antonio Rojas <arojas@archlinux.org>
Build Date      : Wednesday 04 August 2021 01:52:58 PM
Install Date    : Thursday 05 August 2021 11:31:12 AM
Install Reason  : Installed as a dependency for another package
Install Script  : No
Validated By    : Signature

